Overjoyed
My Heart Cries Holy
Encounter
Give Me Your Heart	주의 마음 주옵소서
More Than Anything	내 모든 것 나의 갈망
The Love of God	모든 영혼들 향한
You Broke The Chains	주 내 사슬을
예수보다
Christ Our King	그리스도 우리 왕
4성부합창	그리스도 우리왕
I Will Worship You Forever	경배하리라 영원히
Jesus,I Love You	예수 사랑해요
Sacred Lamb	오 어린양
LET CHRIST BE FORMED IN ME	주 닮게 하소서
I Stand Amazed	주를 경외해
Hosanna
Because of Who You Are	내 주를 인하여
Forever Im Resolved	영원한 내 결단
High And Lifted Up	주 높이 들리셨도다
My Heart Cries Holy
Renovate	새롭게 하소서
We Cry Glory	영광 아버지 앞에
GLORIFY	THE	LORD	오 주님께 영광
GLORY	영광
Come, Lord Jesus, Come	주 임하소서
EVERYTHING I AM	주 나의 모든 것
The Glory of The Cross 	 십자가의 영광
You Must Increase	주님만이 흥하소서
YOU	SHALL	REIGN	영원히 주 다스리리